 R  124088888888888888888888888888888888888888888888 7222222222222222222222222222222222222222222222222220

SO          textures/grey_brick.xpm

WE      textures/wood.xpm

NO      textures/yellow_brick.XPM

EA      textures/red_brick.xpm

S  textures/sprites/barrel.xpm

F      223, 237, 240

C 29, 72, 82

111111111111111111111111111111111111111111111111111111111111111111
100000000000000000000000000000000000000000000001000000000000000001
100200000000020000000000020000000000200000000001000200000000000001
100000000000000000000000100000000000000000000001000000000000000001
100000000000000000000000100000000000000000000001000000000000000001
100000000000000000000000102000000000000000000021000000000020000001
100000200000000200000000100000000000000000000001000000000000000001
100000000000000000000000111111111111100000000001000000200000000001
100000002000000000000000120000000002100000000001000000000200000001
100000000000000000000000000E00000000000000000001000200000000000001
100002000000000001111111100000000000000000000001000000000000000001
100000000000000200000000120000000002100000000001111100000000000001
100000000000000000000000111111111111100000000000000000000000000001
100000000000000000000000020000000000102000000000000000000000000001
100000000020000000000000000000000000100000000000002000000000000001
100000000200000000000000000000020000100000000000000000000000000001
100020000000000000000000000000000000100000020000000000000000000021
100000000000000000002000000000000000000000000000000000000020000001
100000000000000000000000000000000000000200000000000200000000000001
100000000200000000000000000000000000000000000000000000000000000001
111111111111001111111111111100111111111111111111111111110111111111
111111111111001111111111111100111111111111111111111111110111111111
111111111111001111111111111100111111111111111111111111110111111111
111111111111001111111111111100111111111100001111111111110111111111
111111111111000000000000000000111111111100001111111111110111111111
111111111112001111111111111100000000000000000000000000000111111111
111111111110001111111111111200111111111111111101111111110111111111
100000000000000000000000000000000011111111111101111111110111111111
100000000000000000200000000000000011111111111101111111110111111111
100000000000000000000000002000000001111111111101111111110111111111
100000000000000000000000000000000001111111110000000000000000001111
100000000000000000000000000000000001111111111000200000200000001111
111000000000000000000000000000000011111111111000000000000000001111
111000000000000000000000000000000001111111111100000000000000001111
111000000000000000000000000000000000000000000000000000000000001111
111111111111111111111111111111111111111111111111111111111111111111
